1111111111111111111111111
1P00000000000000000000001
1001110011100111001111001
1001C100CC100CC1001CC1001
1000C100CC100CC10000C1001
1000C100111001110000C1001
1000C100CC100CC10000C1001
1000C100CC100CC10000C1001
10001110111001110000C1001
10000000000000000000000E1
1111111111111111111111111