1111111111111
1P11001C10001
10010000000C1
1000011111111
1000110000011
1000C000000E1
1111111111111