11111111111111111111
1P000000000000000001
100000C1100111100001
10000C101001XX100001
10000100100CCC100001
10000111100111100001
10000CCC1001CCC00001
10000CCC100111100001
100000000000000000E1
11111111111111111111