11111111111
100P000C001
1000X000001
100000000E1
11111111111