11111111111
100P000C001
10000000001
100000000E1
11111111111